++++++++++
+-------F+
+--------+
+--------+
+--------+
+--------+
+--------+
+--------+
+P-------+
++++++++++