+++++++++++++++
+------------F+
++--1--------++
+++---------+++
++++-------++++
+++---------+++
++---------2-++
+P------------+
+++++++++++++++